[
    [
        "N0000003.RDB",
        "N0000004.RDB",
        "N0000005.RDB",
        "N0000006.RDB",
        "N0000007.RDB",
        "N0000013.RDB",
        "N0000014.RDB",
        "N0000015.RDB",
        "N0000016.RDB",
        "N0000017.RDB",
        "N0000018.RDB",
        "N0000020.RDB",
        "N0000021.RDB",
        "N0000022.RDB",
        "N0000023.RDB",
        "N0000024.RDB",
        "N0000026.RDB",
        "N0000027.RDB",
        "N0000034.RDB",
        "N0000035.RDB",
        "N0000042.RDB",
        "N0000044.RDB",
        "N0000046.RDB",
        "N0000047.RDB",
        "N0000057.RDB",
        "N0000069.RDB",
        "N0000072.RDB",
        "N0000075.RDB",
        "N0000076.RDB",
        "N0000077.RDB",
        "N0000081.RDB",
        "N0000082.RDB",
        "N0000083.RDB",
        "N0000090.RDB",
        "N0000091.RDB",
        "N0000092.RDB",
        "N0000095.RDB",
        "W0000003.RDB",
        "W0000005.RDB",
        "W0000009.RDB",
        "W0000011.RDB",
        "W0000013.RDB",
        "W0000018.RDB",
        "W0000023.RDB",        
        "W0000025.RDB",
        "W0000026.RDB",
        "W0000029.RDB"
    ],
    [
        "N0000006.RDB",
        "N0000007.RDB",
        "N0000008.RDB",
        "N0000039.RDB",
        "N0000040.RDB",
        "N0000041.RDB",
        "W0000005.RDB"
    ],
    [
        "N0000007.RDB",
        "N0000012.RDB",
        "N0000013.RDB",
        "N0000014.RDB",
        "N0000094.RDB",
        "W0000023.RDB",
        "W0000026.RDB"
    ],
    [
        "N0000009.RDB",
        "N0000010.RDB",
        "N0000011.RDB",
        "N0000012.RDB",
        "N0000013.RDB",
        "N0000014.RDB",
        "N0000015.RDB",
        "N0000016.RDB",
        "N0000017.RDB",
        "N0000030.RDB",
        "N0000032.RDB"
    ],
    [
        "N0000009.RDB",
        "N0000010.RDB",
        "N0000011.RDB",
        "N0000030.RDB",
        "N0000031.RDB",
        "W0000000.RDB",
        "W0000008.RDB"
    ],
    [
        "N0000009.RDB",
        "N0000010.RDB",
        "N0000011.RDB",
        "N0000030.RDB",
        "N0000031.RDB",
        "N0000032.RDB",
        "W0000000.RDB",
        "W0000008.RDB"
    ],
    [
        "N0000005.RDB",
        "N0000007.RDB",
        "N0000008.RDB",
        "N0000019.RDB",
        "N0000033.RDB",
        "N0000034.RDB",
        "N0000035.RDB",
        "N0000037.RDB",
        "N0000038.RDB",
        "N0000043.RDB",
        "N0000057.RDB",
        "N0000058.RDB",
        "N0000061.RDB",
        "N0000062.RDB",
        "N0000064.RDB",
        "N0000065.RDB",
        "N0000073.RDB",
        "N0000074.RDB",
        "N0000077.RDB",
        "N0000081.RDB",
        "N0000082.RDB",
        "N0000083.RDB",
        "N0000084.RDB",
        "N0000085.RDB",
        "N0000086.RDB",
        "N0000093.RDB",
        "W0000001.RDB",
        "W0000002.RDB",
        "W0000004.RDB",
        "W0000006.RDB",
        "W0000007.RDB",
        "W0000014.RDB",
        "W0000017.RDB",
        "W0000022.RDB",
        "W0000027.RDB"
    ],
    [
        "N0000001.RDB",
        "N0000025.RDB",
        "N0000027.RDB",
        "N0000028.RDB",
        "N0000029.RDB",
        "N0000036.RDB",
        "N0000037.RDB",
        "N0000038.RDB",
        "N0000043.RDB",
        "N0000054.RDB",
        "N0000055.RDB",
        "N0000056.RDB",
        "N0000061.RDB",
        "N0000062.RDB",
        "N0000065.RDB",
        "N0000070.RDB",
        "N0000071.RDB",
        "N0000073.RDB",
        "N0000074.RDB",
        "W0000000.RDB",
        "W0000001.RDB",
        "W0000004.RDB",
        "W0000021.RDB"
    ],
    [
        "N0000004.RDB",
        "N0000022.RDB",
        "N0000023.RDB",
        "N0000027.RDB",
        "N0000028.RDB",
        "N0000029.RDB",
        "N0000036.RDB",
        "N0000059.RDB",
        "N0000060.RDB",
        "N0000062.RDB",
        "N0000068.RDB",
        "N0000070.RDB",
        "N0000071.RDB",
        "N0000073.RDB",
        "N0000074.RDB",
        "N0000075.RDB",
        "N0000076.RDB",
        "N0000077.RDB",
        "W0000010.RDB",
        "W0000011.RDB",
        "W0000018.RDB",
        "W0000026.RDB"
    ],
    [
        "N0000000.RDB",
        "N0000003.RDB",
        "N0000025.RDB",
        "N0000033.RDB",
        "N0000034.RDB",
        "N0000035.RDB",
        "N0000037.RDB",
        "N0000038.RDB",
        "N0000054.RDB",
        "N0000055.RDB",
        "N0000056.RDB",
        "N0000058.RDB",
        "N0000065.RDB",
        "N0000081.RDB",
        "N0000082.RDB",
        "W0000001.RDB",
        "W0000002.RDB",
        "W0000003.RDB",
        "W0000006.RDB",
        "W0000007.RDB",
        "W0000014.RDB",
        "W0000021.RDB",
        "W0000022.RDB"
    ],
    [
        "N0000008.RDB",
        "N0000019.RDB",
        "N0000058.RDB",
        "N0000064.RDB",
        "N0000066.RDB",
        "N0000084.RDB",
        "N0000085.RDB",
        "N0000086.RDB",
        "W0000001.RDB",
        "W0000017.RDB",
        "W0000023.RDB",
        "W0000027.RDB"
    ],
    [
        "N0000004.RDB",
        "N0000018.RDB",
        "N0000020.RDB",
        "N0000045.RDB",
        "N0000046.RDB",
        "N0000047.RDB",
        "N0000054.RDB",
        "N0000055.RDB",
        "N0000056.RDB",
        "N0000059.RDB",
        "N0000083.RDB",
        "N0000090.RDB",
        "N0000091.RDB",
        "N0000092.RDB",
        "W0000009.RDB",
        "W0000010.RDB",
        "W0000021.RDB",
        "W0000029.RDB"
    ],
    [
        "N0000006.RDB",
        "N0000008.RDB",
        "N0000020.RDB",
        "N0000021.RDB",
        "N0000026.RDB",
        "N0000045.RDB",
        "N0000046.RDB",
        "N0000047.RDB",
        "N0000057.RDB",
        "N0000059.RDB",
        "N0000069.RDB",
        "N0000072.RDB",
        "W0000005.RDB",
        "W0000011.RDB",
        "W0000015.RDB",
        "W0000024.RDB"
    ],
    [
        "N0000009.RDB",
        "N0000010.RDB",
        "N0000011.RDB",
        "N0000012.RDB",
        "N0000013.RDB",
        "N0000014.RDB",
        "W0000008.RDB"
    ],
    [
        "N0000031.RDB",
        "N0000032.RDB",
        "W0000000.RDB"
    ],
    [
        "M0000000.RDB",
        "M0000001.RDB",
        "M0000002.RDB",
        "M0000003.RDB",
        "M0000004.RDB",
        "M0000005.RDB",
        "M0000006.RDB",
        "M0000007.RDB",
        "M0000008.RDB"
    ],
    [
        "N0000039.RDB",
        "N0000040.RDB",
        "N0000041.RDB",
        "N0000048.RDB",
        "N0000049.RDB",
        "N0000050.RDB",
        "N0000051.RDB",
        "N0000052.RDB",
        "N0000053.RDB",
        "N0000063.RDB",
        "N0000067.RDB",
        "N0000087.RDB",
        "N0000088.RDB",
        "N0000089.RDB",
        "W0000012.RDB",
        "W0000016.RDB",
        "W0000019.RDB",
        "W0000020.RDB",
        "W0000028.RDB"
    ],
    [
        "B0000000.RDB",
        "B0000001.RDB",
        "B0000002.RDB",
        "B0000003.RDB",
        "B0000004.RDB",
        "B0000005.RDB",
        "B0000006.RDB",
        "B0000007.RDB",
        "B0000008.RDB",
        "B0000009.RDB",
        "B0000010.RDB",
        "B0000011.RDB",
        "B0000012.RDB",
        "B0000013.RDB",
        "B0000014.RDB"
    ]
]